neither	[NEGT]
no	[NEGT]
no adequate	[NEGT]
no amendment	[NEGT]
no claim	[NEGT]
no consent	[NEGT]
no effect	[NEGT]
no event	[NEGT]
no failure	[NEGT]
no force	[NEGT]
no license	[NEGT]
no waiver	[NEGT]
none	[NEGT]
nor	[NEGT]
non-public	[PSEU]
not	[NEGT]
not limited	[PSEU]
not only	[PSEU]
nothing	[NEGT]
notwithstanding	[NEGT]
shall not	[NEGT]
void	[NEGT]
without	[NEGT]
without consent	[PSEU]
without limitation	[PSEU]
without limiting	[PSEU]
without restrictions	[PSEU]
without regard	[NEGT]
without violation	[PSEU]
